50
16
#####################################################################################################
#                 #   #     #           #                 #   #       #       #                 #   #
# ##### ######### # # # ### # ### ##### # # ##### ####### # ### ##### # # ##### ########### ### ### #
# #   # #   #   # # # #   #   #   #   # # #     # #     #   #   # #   # #       #         # # #     #
# # # # # # # # # # # ### ##### ### # # ##### # ### ### ### # ### # ### ############# ### # # ##### #
# # # #   # # # #   # #       # #   # #     # #       #   # #     #     #           #   # # # #   # #
# ### ##### # # ##### ######### ### # ##### ######### ### ####### ####### ##### ### ### ### # # # # #
# #       #   #   # #         #   # #       #       #   # #       #     # #   # # # #   #   #   # # #
# # # ########### # ######### ### # ######### ##### # ### # ########### # ### # # # # # # ### ### # #
#   # #   #   #   #   #     #   # #   #       # #   # #   #     #       # #   # #     # #   #   #   #
### ### # # # # ### ### # ##### # ### ### ##### # ### # ####### # # ##### # ### ######### # #########
# # #   #   #   #       #     # # # #     #     # #   #         # #         #   #   #   # #         #
# # # ########### ######### ### # # ######### ### # ######### ### ########### ### # # # ########### #
#   # #   #           #   #       #   #       #   #   #     # #         #   # #   #   #             #
##### # # # ########### # ######### ### # ##### ####### ### # ########### # # # ################### #
#   # # # #   #     #   # #   #         #     #         # # #             #   # #     #           # #
# # # # # ### # ### # ### # # # ############# ########### # # ############### # # # ### ######### # #
# #   # # #   # #     #     # # #           # #   #       # # #     #   #     # # # #   #   #   #   #
# ##### # # ### ############# # ########### # # # # ##### # ### ### # # ### ### # ### ### # # # #####
# # #   #   #   #         # # #   #       # #   #       #       #   # #   #   # #   # #   #   # #   #
# # # ####### ### ####### # # ### # ##### # ##################### ### ### ### # # # # # ####### # # #
# #   # #     #   # #     # #   #   #             #           # #   # #     # # # #   #       #   # #
# # ### # ##### ### # ##### ### ############### ### ######### # ### # ##### ### # ########### ##### #
# # #   #       #   # #     #   #             # #   #       # #   # #     #     #           # # #   #
# # # # ######### # # ##### # ### ########### # # ### ####### # ### ### # ################# # # # ###
# # # #   #       # #     # # # #   #       # # #   #       # #   #   # # #   #           #   # # # #
# # # ### ### ########### # # # # # ##### # # ### # # ##### # # # ### # # # # ##### ########### # # #
# # # #       #     #   # #   #   #     # # #   # # # #     # # #   # # #   # #     #           #   #
# # # ######### ### # # # # ########### ### ### # # # # ##### ### # # ####### # ### # ######### ### #
# # #       #   #     #   #             # #   # # # # # #     #   # # #       #   # # #       #     #
# # ####### # ################# ######### # # # ### # # # ##### ##### # ####### # ### # ### # #######
# #   #     # #       #         #     #   # # #     # # #     #         #   #   # #   # #   #       #
# ### # ### # # ##### # ######### ### # ##### ######### ##### ########### # ### # # ##### ### #######
# #   # #   #   #     #         #   #   #       #       #   #           # #   # # #   #   #   #     #
# ### # # ####### ### ############# ##### # ##### # ### # ############# # ### ### ### # ####### ### #
#   #   #   # #   #   #       #   # #   # # #   # # #     #         #   #   #   # #   #           # #
# # ####### # # ####### ##### # # # # # # ### # # # ####### # ####### ##### ### # # ### ######### # #
# #       #   #         #   #   # #   # # #   #   #         #         #     #     #   #     #   # # #
# ####### ### ############# ##### ##### # # ############################# ####### ### ####### # ### #
#   #     #     #               #       #   #   #                         #     #   # #       #   # #
### # ##### ##### # ##################### ### # # ### # ################# # ### ### # # ######### # #
#   #   #   # #   #     #             # # #   #     # # #               # #   #   # # # #       #   #
# ##### # ### # ####### # ####### ### # # ######### # ### ############# ##### ### ### # ##### ##### #
# #     #     #   # #   # #     # #   # #       #   #   # #     #     #         #   # #     #     # #
# # ####### ##### # # ### # ##### ### # ####### ##### # # # ### ### ############### # ##### # # # # #
# # # #   # #     # #     # #   #   # #       #     # #   #   #   #       #       # #     # # # # # #
### # # # # # ##### ####### # # ### # # ##### ##### # ##### # ### ### ##### ##### # ##### # ### ### #
#   #   #   # #       #       # #   # # #     #   # #     # # # #   #     #   #       # # #   # #   #
# ### ####### # # ### ######### # ### ### ##### # # ##### ### # ### # ### ### # ##### # # ### # # ###
# # #   # #   # #   #           # #       #     # # #   # #   # #   #   #   # # #   #   # #   # # # #
# # ### # # ####### ### ####### # ######### ##### # # ### # ### # ######### # ### # ##### # ### # # #
# #     # # #       #   #     # #           # #   # #     # #   #         # #     #     #   #   #   #
# # ##### # ### ######### ### ############### # ### # ##### ### ######### # ########### ##### # ### #
# #   #   #   #         # # #                 #     #   #     #         #     #   #   #     # #   # #
# ### ### ### ######### # # ######### ####### ######### ### # # ####### ##### ### # # # ### # # ### #
#   #     # #         #             #     #   #       #   # # # #           #   #   # #   # # #   # #
# # ##### # ######### ############# ##### ### # ##### ### ### # # ############# # ### ### # # ### # #
# #   #       #     #       #     # #   #   # #   # #   #     # #     #         # #   #   # # # # # #
# ### # ##### ### ######### # ### ### # ### # ### # ### ####### ##### # ########### # # ##### # # # #
# #   # #   #   #         #   # # #   #     #   # #   #       # #     #   #         # # #   # # #   #
# # ##### # ### ### ##### ##### # # ########### # # # ##### # # # ### ### ##### ####### # # # # #####
# #   #   # #     # #       #   # #     #       # # #     # # # # #   # #     #       #   #   #     #
##### # ### ##### ### ##### ### # ##### # ####### ### # ### # # # # ### ##### # ##### ######### ### #
#   #   #   #   #     #         #     # # #     # #   # #   # # # # #       # #   # #     #     #   #
# # ##### # # # ############### ##### # # ### ### # ##### ### ### # # ##### # ### # # ##### ##### # #
# #       # # #     #         #   #   # #   #       #   # # #   # #   # #   # #     #       #     # #
# # ######### ##### # ####### ### # ### ### ######### # # # ### # ##### # ### ##### ######### ##### #
# # #           #   # #   # # #   #     #   #         # # #   #   #   #   # #   # # #   #     # #   #
# ### ######### # # # # # # # ########### ### ######### # ### ##### # # ### ### # # # # # ##### # ###
# #   # #     # # # #   #   #       #     #   # #   #   #   # #     # # #     # #     # # #     # # #
# # ### # ### ### # ####### ##### ### ##### ### # # # ##### # # ### ### # ### # # ####### # # ### # #
# # #   # #       # # #     #   #     #     #   # # #       #   #   #     #   # # #       # # #   # #
# # # ### ######### # # ####### ####### # ### ### # ############# ### ######### ### ######### # ### #
#   #   #   # #     # #       #     #   # #     # # #             #   # #       #   #         # #   #
# ##### ### # # ##### ####### # # # # ### ##### # # # ### ####### # ### # ####### ### ### ##### # ###
#         # # #     #       # # # # #   # #   #   # # # #   #   # #     #     #   #     # #   # #   #
####### ### # ##### # ### ### ### # ##### # # ### # # # ### # # ####### ##### ### # ### ### # # ### #
#     # #   #     # # # #   #   # #       # #   # #       #   #       # #   # #   #   # #   # # #   #
# ### # # ####### # # # ### ### # ######### ### # ####### ########### # # ### # ### ### # ### # # ###
#   #   # #       # #     #   # #   #       #   # # #   # #         # #   #   #   # #   # # #   #   #
### ##### ### ### # ##### # ### # # # ####### ### # # # ### ####### # ### # ##### # # ### # ##### # #
#   #   #   #   # #     # # #   # #   #     #   #   # #     #     # # #   #       # #     #   #   # #
# ### # ### # # ####### # # # ##### ### ### ### ### # ######### # # # # ########### ####### # ##### #
#   # #     # #       # # # #     #   #   #   # #   #           # # #     # #     # #     # #       #
##### ####### ##### ### ### ##### ### # ##### # # ############### # ##### # # ### # ### # # ####### #
#   # #     # #   #     #       #   # # #     # # #         #     #     #   #   # #     # #   #   # #
# # # # ### # # ######### ##### ### # ### ##### # ##### ### # ######### ####### # ####### ### # ### #
# #   # # # # #           #     #   # #   #   # #     # #   #   #     #   #     #       # #   # #   #
# ##### # # # ### ############# # ### # ### # # ##### ### ##### # ### ### # ##### ##### # # ### # ###
#   #   # # #     #   #       # # #   # #   #   #   #   #     # # #     #   #   # #   # #   #   # # #
# # # ### # ##### # # # ##### ### # ### # ####### ##### # # # # ### ########### # # # ######### # # #
# #   #   # #   # # # #   # # #   # #   #       #   #   # # # #   #             #   #           # # #
# ####### # # # # # # ### # # # ### ### ####### ### # ### # ##### ##### # ##### ######### ####### # #
#       # #   # # # # #   # #   #         #   # #   #   # # #   #     # # #   #     #   #       # # #
####### # ##### ### # # ### ############# # ### # ##### ### # # ##### # # # ####### ### ####### # # #
#     #   #   #     # # #         #     # #   # #           # #   #   # # #   #   # #     #   # # # #
# ### ### ### ####### # # ####### ### ### # # # ########### # # # # ##### ### # # # # ### # ### # # #
# #   #   #   #     # #   #     #   # #   # # # #     #   # # # # # #   #   # # # # # # # #   #   # #
# # ### ### # ### # # ##### ### ### # # ##### # # ### # # ### # ### # # ### # # # # # # # ### ##### #
# #         #     # #         #     #         #     #   #     #       #     #   #     #             #
#####################################################################################################
