61
13
#############################################################
#       #     #                       #     #   #     #     #
# ####### # ### ######### ############# # # ### # # # # ### #
#         #     #       #             # # #   #   # # # # # #
# ############### ##### # ########### # # ### ##### ### # # #
#     #     #     #   # #     #     #   #   # #   #       # #
##### ### # # ##### # # ##### ### ######### # # # ######### #
#   # #   # # # #   # # #   #   #         # #   #   #       #
# # # # ##### # # # # # # # ### # ####### # ####### # ##### #
# #     #     #   # # # # #   # # #     # #       # # #   # #
# ####### ######### ### # ### # # ### # # ####### # # # # # #
# #       #       # #   # #   # #     # #       # # # # #   #
### ####### ##### # # ### ##### ####### # ##### # # # # #####
#   #     #   # # # #   # #         #   #     # # #   # #   #
# ##### # ### # # # ### # # ####### # ####### # # ##### # # #
#     # #     # # #   # #   #   #   # #   #   # #   #   # # #
##### # ####### # ### ####### # # ##### # # ### ### # ### # #
# #   #     #   #   #         # #       #   #   #   # #   # #
# # ####### # # ### ##### ##### ### ########### # ##### ### #
# # #       # #     #     #     #   #         # # #       # #
# # # ####### ####### ##### ######### ####### # # # ####### #
# # # #   #   #       #   # #         #   #   # #     #     #
# # # # ### ### ### ### ### # ### ##### # # ### ##### # ### #
# # # #     #   #   #   #   #   #   #   #   #   #   # # # # #
# # # ##### # ### ##### # ######### # ####### ### # ### # # #
#   # #   # #   #     #   #         # #     #   # #     #   #
# ### # # # ####### # ### ### ####### # ### ##### ####### ###
# #     # #       # #   #     #     #   # # #     #     # # #
# ### ### ####### ### # ########### ##### # # ##### # ### # #
#   #   #   #   #   # #           #       #   #   # #     # #
### ##### # # ##### ##### ####### ####### ##### # # ####### #
#   #   # # #       #   #       #       #       # #     #   #
# ### # ### # ####### # ####### ####### # ####### ##### # # #
#   # # #   #   #     #   #   # #   #   #     #   #   # # # #
### # # # ##### # ### ### ### # # # # ### ### # ### # # ### #
# #   # # #   # #   #   #   # #   # # # # # # #     # #   # #
# ##### # # ### ### ### ### # ### ### # # # # # ######### # #
#     #   #   # #   #   #   # #   #   # #   # # #       # # #
# ### ####### # ##### ### ### # ### ### ### # ### ##### # # #
# #     #     #   #   # #   #     # #     # #     #   #   # #
# # ##### # ##### # ### ### ####### # ### # ######### ##### #
# # #   # #       #   #   #         # # # #   #     #       #
# # # # # ########### # # ########### # # ### # ### # ##### #
# #   #   # #         # #         #   # # # #   # # #   # # #
# ######### # ##### ### ##### ### # ### # # ##### # ### # # #
# #         # #   #   #     #   #   #   # #     #   #   # # #
# # ##### # # # # ### ####### # ##### ### ##### # ### ### # #
# # # #   # # # #   # #     # #   #     #     # # #   #   # #
# # # # ##### # ### # # ### ##### # ### ##### # # # ### # # #
# # # #       #   # #   #   #     #   #     # # #   #   # # #
# # # ##### ##### # ##### ### ####### ### ### # ##### ### # #
# #   #   #   #   # #   #   #     #     #     #   #   #   # #
# ### # # ### ##### # # ### # ### ####### ##### ### # ##### #
#   # # # #         # #   # #   # #     # #     #   #     # #
### ### # # ######### ### # ##### # ### # ### # # ####### # #
# #     # # #   #   # #   #     # # #   #     # # #   #   # #
# ####### ### # # # # # ##### # # # # ######### # ### # ### #
#       #   # # # #   # #   # # # # #     #   # #   # #     #
# # ####### # # # ##### # # ### # # ##### # # ##### # #######
# #           #   #       #     #       #   #               #
#############################################################
