9
2
#########
#   #   #
# # ### #
# #   # #
# ##### #
#   #   #
### # # #
#     # #
#########
