31
1
###############################
# #     #             #       #
# # ### # ####### ##### ### ###
#     # #   #   #     #   #   #
##### # ### ### ##### ### ### #
#   # #   #     #   #       # #
# # # ### ##### ### ######### #
# # #   #     #   #     #   # #
# # ######### ### # ### # # # #
# #       #   #   # # # # # # #
# ####### # # # ### # # # # # #
#   #   # # # # #     # # #   #
# # ### # # ### # ##### # ### #
# #   #     #   # #     # #   #
# ### ####### ### # ### # # ###
#   #         #   # # # # #   #
# ### ########### # # # # ### #
# # # #         # # #   # #   #
# # # ### ### # ### ### # #####
# # #   # #   #   #   # #     #
# # ### ### ##### ### ####### #
# #   #     #   #   # #       #
##### # ####### ### # # ##### #
#   # # #     #       # #   # #
# # # ### ### # ####### # ### #
# #   #   #   #   #     # #   #
# ##### ### ####### ##### # ###
#       # #       #   #   # # #
######### ####### ### # ### # #
#                     #       #
###############################
