61
13
#############################################################
#       #     #                       #     #   #     #     #
# ####### # ### ######### ############# # # ### # # # # ### #
#         #     #       #             # # #   #   # # # # # #
# ############### ##### # ########### # # ### ##### ### # # #
#     #     #     #   # #     #     #   #   # #   #       # #
##### ### # # ##### # # ##### ### ######### # # # ######### #
#   # #   # # # #   # # #   #   #         # #   #   #       #
# # # # ##### # # # # # # # ### # ####### # ####### # ##### #
# #     #     #   # # # # #   # # #     # #       # # #   # #
# ####### ######### ### # ### # # ### # # ####### # # # # # #
# #       #       # #   #:#   # #     # #       # # # # #   #
###.####### ##### # # ###:##### ####### # ##### # # # # #####
#...#.....#   # #:# #   #:#         #   #     # # #   # #   #
#.#####.# ### # #:# ### #:# ####### # ####### # # ##### # # #
#     #.#     # #:#   # #   #...#   # #   #   # #   #   # # #
##### #.####### # ### ####### #.# ##### # # ### ### # ### # #
# #   #.....#   #   #         #.#       #   #   #   # #   # #
# #.#######.# # ### ##### #####.### ###########.# ##### ### #
# #.#       # #     #     #.....#   #         #.# #       # #
# #.# ####### ####### #####.######### ####### #.# # ####### #
# #.# #   #   #       #   #.#         #   #   #.#     #     #
# #.# # ### ### ### ### ###.# ### ##### # # ###.##### # ### #
# #.# #     #   #   #   #...#   #   #   #   #   #   # # # # #
# # # ##### # ### ##### # ######### # ####### ### # ### # # #
#   # #   # #   #     #   #         # #     #   # #     #   #
# ### # # # ####### # ### ### ####### # ### ##### ####### ###
# #     # #       # #   #     #     #   # # #     #     # # #
# ### ### ####### ### # ########### ##### # # ##### # ### # #
#   #   #   #   #   # #           #       #   #   # #     # #
### ##### # # ##### ##### ####### ####### ##### # # ####### #
#   #   # # #       #   #       #       #       # #     #   #
# ### # ### # ####### # ####### ####### # ####### ##### # # #
#   # # #   #   #     #   #...# #...#   #     #   #   # # # #
### # # # ##### # ### ### ###.# # #.# ### ### # ### # # ### #
# #   # # #   # #   #   #   #.#   #.# # # # # #     # #   # #
# ##### # # ### ### ### ### #.### ### # # # # # ######### # #
#     #   #   # #   #   #   #:#   #   # #   # # #       # # #
# ### ####### # ##### ### ###:# ### ### ### # ### ##### # # #
# #     #     #   #   # #   #     # #     # #     #   #   # #
# # ##### # ##### # ### ### ####### # ### # ######### ##### #
# # #   # #       #   #   #:::::::::# # # #   #     #       #
# # # # # ########### #.# ########### # # ### # ### # ##### #
# #   #   # #         #.#         #   # # # #   # # #   # # #
# ######### # ##### ###.##### ### # ### # # ##### # ### # # #
# #         #.#   #   #     #   #   #   # #     #   #   # # #
# # ##### # #.# # ### ####### # ##### ### ##### # ### ### # #
# # #.#   # #.# #   # #     # #   #     #     # # #   #   # #
# # #.# #####.# ###:# # ### ##### # ### ##### # # # ### # # #
# # #.#       #   #:#   #   #     #   #     # # #   #   # # #
# # #.##### ##### #:##### ### ####### ### ### # ##### ### # #
# #   #   #   #   #:#   #   #     #     #     #   #   #   # #
# ### # # ### #####:# # ### # ### ####### ##### ### # ##### #
#   # # # #         # #   # #   # #     # #     #   #     # #
### ### # #:######### ### # ##### # ### # ### # # ####### # #
# #     # # #   #   # #   #     # # #   #     # # #   #   # #
# ####### ### # # # # # ##### # # # # ######### # ### # ### #
#       #   # # # #   # #   # # # # #     #   # #   # #     #
# # ####### # # # ##### # # ### # # ##### # # ##### # #######
# #           #   #       #     #       #   #               #
#############################################################
