3
#####################################################################################################
#     #                 # #         #       #     #       #         #     # #       #             # #
### # # ####### ####### # # ### ### # ##### ### # # ### # ### ##### # ### # # ##### # ### ####### # #
#   # #   #   #       # #     # #     #   #     # #   # #     #   #   #     #   # #   #   #     #   #
# ### ### # # ### ### # ##### # ####### # ####### ##### ######### # ########### # ##### ### ### ### #
# #   #   # #   #   # #     # #   #   # #   # #   #   #   #       # #           #   # #   # #   #   #
# # ### ### ### ##### ##### ### # # # ### # # # ### # ### ### # ### # ########### # # ### # # #######
# # #     #   # #     #       # # # #     #   # #   #     #   # #   #   #         #     # # # #     #
# ### ##### # # # ########### ### # ######### # ### ####### ##### ##### ##### ######### # # # # ### #
#   # #   # # #   #       # #   # #   #     # #     # #       #   #     #     #       # #   #     # #
# # # # # ### # ### ##### # ### # ### # # ### ####### # ##### # ### ##### ##### ##### # ########### #
# #   # #     # #   #   # #   # # #   # #     #       # # #   # #   #     #     #     # #     # #   #
# ##### ####### # ### # # # ### # # ### ####### ##### # # # ### # ### ##### ##### ##### # ### # # # #
#   #   # #     # # # #   # #   # #   #     # # #   # # # #     #   #   #   #   #     #   #     # # #
# ### ### # ##### # # ##### # ### # # ##### # # # # # # # ##### ### # # # ### ####### # ######### ###
# #   #   #   # # # #   #         # #   #     # # #   #   #   #   # # # # #       #   # #   #   #   #
### ##### ### # # # ### ############### # ##### # ##### ### # ##### ### # ##### ### ##### # # # ### #
#   #   #       # #   #           #     # #     #   #   #   #     #     #     #     #     #   #     #
# ### # ######### # # ########### # ####### ####### # ### ####### # ####### # ### ### # #############
#   # #       #   # #     # #     #             # #   #   #     #   #     # #   #     # #           #
### # ####### # ### ### # # # ######### ####### # ##### ### ### ##### ### ### # ### ##### ######### #
#   # #     #   # # # # #   #         # #   # #       #   #   # #   # #     # # #   #   # #     #   #
# # # ##### ##### # # # ### ######### ### # # # ######### # # # ### # ##### ### # ### # # # ##### # #
# # #   #     #       #   # #       # #   # #   #     #   # # #     #     #     #   # #   #   #   # #
# ##### # ### ######### # ### ##### # # ### ##### ### # ### # ##### ##### ######### # ####### # ### #
#     # # # # #       # #       #   #   # #       # #   #   #     # #   #         # # #       # #   #
# ### # # # # # ##### # ####### # ####### ######### ##### ####### # # # ######### # # # # ### # ### #
# #   #   # #   #   # # #     # #     #       #   #     # #     # # # #     # #   # # # # # # #   # #
### ####### ##### ### ### ### # ##### # # ### # # # # ### ### ### # # ##### # # ### # ### # # ### # #
#   #   #       #   #   # #   # #   # # # #   # # # # #       #   # #   #     # #   # #   #   #   # #
# # # # # # ### # # ### # ### # ### # # # ##### # # # # ####### ### ### # ##### # ### # ####### ### #
# # # #   # #   # #     #   # #     #   # #     # # # # # #     # #     # #   # # #   # #   #   #   #
# ### ##### ### # ######### # ########### # ##### # # # # # ##### ##### ### # # ### ### # # # #######
#         #   # #   #       # #         #   #   # # #   # # #   #     # #   #   #   # #   # #       #
############# ##### ### ##### # ####### ##### # # # ##### # # # # ### # # ####### ### # ### ####### #
#     #   #   #   #     #     #   #   #       # # #     # # # #   #   # #         #     #     # #   #
# ### # # # # # # ####### ####### # ########### # ##### # # # ##### # # ########### ##### ### # # # #
# # #   # # # # #   #   # #   #   #           # #     # # # # # #   # #   #     #   #   # # # # # # #
# # ##### # ### # # # # # # # # ##### # ##### # ### ### # # # # # ####### ##### # ### # # # # # # # #
# #     # #     # #   # # # #   #   # # #     #   #   #   # #   #   #     #   #   #   #   #   # # # #
# # ##### # ##### ##### # # ##### # ### # ####### # # ### # ##### # # ##### # ##### ######### # # ###
# #   #   # #     #     # #     # #   # # #       # #     # #   # #   #     #     # #       #   #   #
# # # # ##### ##### ##### ##### # ### # # # ############### # # ##### ### ####### # # ##### ####### #
# # #   #     #   # #   #     # # #   # # #     #     #     # #     #   # #     # #     #   #     # #
# ##### ### ##### # # ####### # # ### # ####### # ### # ### # ##### ### # # # ### ####### # # ### # #
# #   #   #     #     #   #   # #   #   #   #   # # #   # # # #       #   # #   #     #   # #   # # #
# # # ### ### # ####### # # ### ### # ### # # ### # ##### # # ####### ##### ### ##### # ### ### # # #
#   # # #   # #     #   # #     #   # #   #   #   #     #   #     #       #   #     #   # # # # #   #
##### # ### ### ### # ### ####### ### # ####### ### ### # ####### ####### ### ##### ##### # # # ### #
#   # #       #   # # # #   #     #   #   #   #   # #   #     # #   #   #   # # #   #       # #   # #
# # # ####### # ### # # # # ### ### ##### # # ### # ######### # ### # # ### # # # ### ####### ### # #
# # #   #   # # #   # # # #   #   # #       #     #           #   # # # #   #   #             #   # #
# # ### # # # ### # # # # ### ### # # ############# ########### # # # # # ##### ############### ### #
# #     # # #   # # #   # #       # #   # #   #         #       # # # #   #   # #   #         # #   #
# ####### # ### # # ### # ### ##### ### # ### # ####### # # ####### # ##### # # # # # ####### # # ###
#       # #   #   # #   #   # #   # #     #   # #     #   # #       # #   # # #   # # #     # # # # #
# ##### # ### ##### # ##### ### # ### ##### ### # ### # ##### ####### # ### # ### ### # # ### # # # #
# #   # # # #   #   # # #   #   #   # # #   #   # #   # #     #   #   #     #   # #   # #   # # #   #
### # # # # ### ##### # # # # ##### # # # ### ### # ##### ####### # ##### ### ### # ### ### # # ### #
#   # # # # #   #     # # # # #   #     # #   #   # #   # #     #   #   # #   #   # #     # # #   # #
# ### # # # # # # ##### # # # # ######### # ### ### # # # # ### # ### # ### ### ### ##### # # ### # #
# #     # # # # # #     # # # #     #     # #   #     # #     # # #   #   #       #   #   #   #   # #
# ##### # # # ### # ### # ### # # ### ####### ######### ####### # # ##### # ######### # ####### #####
# #   # # # #     # #   #     # #   #       #     #   #         # # #   # #     #     #         #   #
# # # ### # ####### # ############# ####### ### # ### ########### # # # # ##### # ####### ####### # #
# # #   #   #       # #               #   #   # # #   #         # # # # # #     #   #     #     # # #
# # ### ### ##### ### ##### ### ##### ### ### ### # ### ####### # # # # # # ####### # ##### ### # # #
# #   #   # #     # #     #   #   # #   #   #     #     #   #   # # # # # #     #   # #       #   # #
# ### ### # # ##### ##### ####### # ### # ######### ####### # ### # # ### ### ### ##### ######### # #
# #     # #   #         # #       #   # #     #   # #     # #   #   #   #   # #   #     #   #   # # #
# # ##### ##### # ####### # ####### ### # ### # # # ### # # ### ####### ### ### ### ##### # # # ### #
#     #   #     # #     # # #       #   # # #   #       #   #   #       # #   #     # #   #   #   # #
# ##### # # ##### # ### # # ##### # # ### # ################# # # ##### # ### ##### # # ######### # #
# #     # # #   # #   #   # #   # # # # #     #     #   #     # #   #   #   #     # # #   #     #   #
# # ##### # # # # ### ##### # # ### # # ##### # ##### # # ##### # # # ##### ##### # # ### # ### #####
# #   # # #   # # # #   # #   # #   # #     # #     # # # #     # # #     #     # #   #   #   # #   #
# ### # # ##### # # ### # # ### # ### # # # # ##### # # # # ####### ##### ### # # ### # ##### # ### #
# #   # # #     #   #   # # #   #     # # # #     # # #   # #     #     #   # # #   # #     # #     #
### ### # # ######### ### # # ### ##### # ####### # # ##### ### # ##### ### ### ### # ##### # ##### #
#   #   # # #       #   #   # # # #   # #   #   #   #     #   # #       #     #   # # #   # #     # #
# ### ### # # ##### ### # ### # # # # ##### # # ### ##### ### # ############# # # # ### # # # ### # #
#   #   # # # #   #     #   # #   # # #     # #     #   #   #   #   #     #   # # #     #   #   # # #
# # # # # # # ### ######### # # ### # # ##### ######### ### ##### # # ### # ##### ############# # ###
# # # #   # # #     #     # # #     # #       #           #       # # # # #       #       #     #   #
# # ##### # # # ### ### # # # ####### # ####### ### ##### ######### # # # ####### ##### # ##### ### #
# # #   #   # # #     # # # #       # #     #     # #   # #   #   #     # #     #       # #   #   # #
# # # # ##### # ##### # # # ####### # ##### ####### # ### # # # # ####### # # ########### # # ##### #
# # # #     # #   # #   # #       # # #     #     # # #   # #   #   #   # # #   #       #   #     # #
# # # ##### # ### # ##### # ####### # ##### # ### # # # ### ####### # # # # ### # ##### ######### # #
# #       # #     #   #   # #       #     #   #   # #     #   #   #   # # # #   # #   #     #     # #
##### ##### ####### # # ##### ########### ##### ### ######### # # ##### # # # ### # ##### # # ##### #
#   # #     #       # # #     #     #   # # #       #     #   # # #   #   # #     #   #   # #   #   #
# # ### ### # ### ##### # ##### ##### # # # # ####### ### # ### ### # ##### ######### # ####### # # #
# #   # #   # # # #     #   # #     # #   #   #       #   # #   #   #   # #     #     #       #   # #
# ### # # ### # # # ####### # # ### # ######### ####### ### # ### ### # # ##### # ### ##### # ##### #
# #     #   # # #   #       #   # # # #         #     #     #     # # #     #   #   # #   # #     # #
# ########### # ####### ##### ### # # # # ####### ### ####### ##### # ##### # ##### ### # # ####### #
# #         #   #     #   # #     #   # # #   #     #   #   #     # #     # # #   #   # #   #   #   #
# # ####### ### ### # ### # ##### ####### # # # ### ##### # ##### # ##### ### # # ### # ##### # # ###
#         #         #     #               # #     #       #             #       #     #       #     #
#####################################################################################################
