41
7
#########################################
# #             #       #           #   #
# # ########### # ##### # # ####### ### #
# # #       # #   #     # #       # #   #
# # ##### # # ##### ##### ####### # # # #
# #   #   # #     #   #   # #     #   # #
# ### # ### ##### ### # ### # # ####### #
#   #   #   #       # #     # # #   #   #
# ####### ### ### ### ##### # ### # #####
#     #   #   # # #   # #   #     #     #
# ### # ### ### # # # # # ######### ### #
#   #   #   #     # #   # #   #   # #   #
### ##### # # ##### ### # # # # # ### # #
# # # #   # # #   #   # # # #   #   # # #
# # # # ### # # # ### ### # ####### # # #
# # # # #   #   #   #     # #     # # # #
# # # # # ######### ####### # ##### # # #
#   #   #         #     #   # #     # # #
# ### ########### ### ### ### # ##### ###
# #     #       # #   #   #     #       #
# ####### ##### # ### # ##### ######### #
# #       # #   #   # # #   # #       # #
# # ####### # ##### # # # # # # ##### # #
#   # #     #     # # #   # #   #     # #
##### # ### ##### # ####### ##### ##### #
# #     #     # # #       # #   # #     #
# # ##### ### # # # ##### # ### # # ### #
# # # #   # # # # #     # #   #     # # #
# # # # ### # # # ####### ### # ##### # #
# #   # #     # #   #       # # #   #   #
# ### # # ##### ### # ##### # ### # # ###
# #   # #   #     # #     # # #   # # # #
# # ### ### # ##### ##### ### # ### # # #
#   # # #     #   #     # #   #   # #   #
# ### # # ##### # ##### # # ##### # #####
#     # # #     #       # #       #     #
##### # # # ############# ############# #
#   # # # # #     #   #       #   #   # #
# ### # ### # ### # # ### ### # # # ### #
#     #       #     #     #     # #     #
#########################################
